C 225,30,42
F 121,121,121


WE ./imgs/purplestone.xpm

EA ./imgs/redbrick.xpm

NO ./imgs/greystone.xpm

SO ./imgs/wood.xpm




11111111
110010111
1001 10N01
1011110111
11111111




