
NO ./imgs/greystone.xpm
SO ./imgs/wood.xpm
WE ./imgs/purplestone.xpm
EA ./imgs/redbrick.xpm

F 121,121,121
C 225,30,0


111111111
110000001
100010001
100100001
100N10001
100000001
111111111
