NO ./imgs/greystone.xpm
SO ./imgs/wood.xpm
WE ./imgs/purplestone.xpm
EA ./imgs/redbrick.xpm

F 121,121,121
C 135,206,235

11111111111111111111111111111
10000000001100000000000000001
10110000011100000010000100001
10010000000000000000000100001
10110000011100000000000100111
10000000001100001110111100001
11110111111111111000000100001
1111011111111  11101010010001
11000000110111111100000100001
10001000000000001100000100001
10000000000000001101010010001
10000000000000001101010010N01
11000001101010111110111100001
11110111111010111110111100001
11111111111111111111111111111
10001000000000001100000100001
10000000000000001101010010001
11111111111111111111111111111
