
NO ./imgs/greystone.xpm
SO ./imgs/wood.xpm
WE ./imgs/purplestone.xpm
EA ./imgs/redbrick.xpm

F 121,121,121
C 225,30,0


111111111
1100000 1
100010001
1001 0001
100N10001
100000001
111111111
