
NO ./imgs/greystone.xpm
SO ./imgs/wood.xpm
WE ./imgs/purplestone.xpm
EA ./imgs/redbrick.xpm

F 121,121,121
C 225,30,0


11111111
11000001
10010001
10100001
11111111
