NO ./path_to_the_north_texture
SO ./path_to_the_south_texture
WE ./path_to_the_west_texture
EA ./path_to_the_east_texture

F 200,100,50
C 50,200,50

1111111111111
1000000000001
1011111011101
1000001000101
1111011110101
1001000000101
1011111111101
100000S000001
1111111111111
