
NO ./imgs/greystone.xpm
SO ./imgs/wood.xpm
WE ./imgs/purplestone.xpm
EA ./imgs/redbrick.xpm

F 121,121,121
C 0,0,0

11111111111111111
10000010000000001
10000000000000001111111111111111111
10000000000000000000000000000000011
10000000000000001111111111111111111
10000000000000000000000000000000011
10000000000000001111111111111111111
10000000000100000000000000000000001
11111111100000000000000000000000001
11000000000000000000000000000000001  
11111111100000000000000000000000001
11000000000000000000000000000000001
1111111110000000000000N000000000001
111111111111111111111111111111111111
