NO ./imgs/greystone.xpm
SO ./imgs/wood.xpm
WE ./imgs/purplestone.xpm
EA ./imgs/redbrick.xpm

F 121,121,121
C 225,30,5

11111111
1100000111
10010000W1
1011000111
11111111
