
NO ./imgs/greystone.xpm
SO ./imgs/wood.xpm
WE ./imgs/purplestone.xpm
EA ./imgs/redbrick.xpm

F 220,100,0
C 225,30,0


11111
10001
10E01
10101
11111
